+----+----+----+----+----+----+----+----+----+----+----+----+----+----+----+
               |              |                             |              |
+----+----+    +    +----+    +    +----+----+----+----+    +----+----+    +
|         |         |         |    |         |              |         |    |
+    +----+----+----+    +----+    +    +----+    +    +----+    +    +    +
|                   |              |    |         |    |         |         |
+----+----+----+    +----+----+----+    +    +----+    +    +----+----+    +
|              |                   |         |    |    |         |         |
+    +----+----+----+----+----+    +    +----+    +    +----+    +    +----+
|                   |         |         |              |    |    |         |
+----+----+----+    +    +    +----+----+----+    +----+    +    +----+    +
|                   |    |    |                   |         |         |    |
+    +----+----+    +    +    +    +----+----+----+    +    +----+    +    +
|              |         |    |         |         |    |    |         |    |
+----+----+----+    +----+    +    +    +    +    +    +    +    +----+    +
|              |    |              |    |    |         |         |         |
+    +----+    +    +    +----+----+    +    +----+----+----+----+    +----+
|         |    |    |    |         |    |         |              |    |    |
+----+    +    +    +    +----+    +----+----+    +    +----+    +    +    +
|    |    |    |    |                             |    |         |         |
+    +    +    +----+----+----+    +----+----+----+    +----+    +----+----+
|         |                                            |         |         |
+----+----+----+----+----+----+    +----+----+----+----+    +    +    +    +
|                             |         |              |    |    |    |    |
+    +----+----+----+----+    +----+    +    +----+    +    +    +    +    +
|              |         |              |         |         |         |    |
+----+----+    +    +----+----+----+----+----+    +----+----+----+----+    +
|    |         |         |              |         |         |              |
+    +    +    +----+    +    +----+----+    +----+    +    +----+----+    +
|         |              |                   |         |
+----+----+----+----+----+----+----+----+----+----+----+----+----+----+----+
