#####################################################################################################
          #                   #         #    #                   #    #              #         #    #
######    #    ###########    #    #    #    #    ###########    #    #    ######    #    #    #    #
#         #              #    #    #    #         #              #         #         #    #         #
#    ################    #    #    #    ###########    #####################    ################    #
#         #    #         #    #    #              #    #                   #    #              #    #
######    #    #    ######    ###########    #    #    #    ######    ######    #    #    ######    #
#         #         #              #         #    #    #         #              #    #    #         #
#    ################    #    #    #    ###########    ###########    ###########    #    #    ######
#    #              #    #    #    #    #              #    #         #         #    #         #    #
#    #    ######    #    #    #    #    #    ###########    #    ###########    #    ###########    #
#    #         #    #    #    #              #                   #         #                        #
#    ######    #    #    #    ######    ######    ######    ######    #    ######    ################
#    #         #    #    #         #         #    #    #    #         #                             #
#    #    ######    #    ######    ######    #    #    #    ###########    ######    ###########    #
#              #    #         #         #         #                   #    #    #    #         #    #
######    ######    ######    ######    ################    ######    #    #    #    #    ######    #
#         #         #         #         #         #         #    #    #         #         #         #
#    ######    ######    ######    ###########    #    ######    #    #####################    ######
#    #    #    #         #         #              #              #         #         #    #         #
#    #    #    #    ######    ###########    ##########################    #    #    #    ######    #
#         #    #    #         #         #    #         #              #         #    #         #    #
###########    #    #    ######    #    #    #    #    #    #####################    ######    #    #
#                   #              #    #    #    #    #                        #         #         #
################    ################    #    #    ##########################    ######    #    ######
#         #    #                   #         #              #              #         #    #    #    #
#    #    #    ######    ######    ######    ###########    #    ######    #    #    #    #    #    #
#    #    #    #         #         #         #         #    #         #    #    #    #              #
#    #    #    #    ######    ######    ######    ######    ######    #    #    #    ######    ######
#    #         #    #         #    #         #                        #    #    #    #         #    #
#    ###########    #    ######    ######    ##########################    #    #    #    ######    #
#              #    #                   #         #         #         #    #    #    #    #         #
###########    #    ###########    #    ###########    #    #    #    #    #    #    #    #    ######
#         #         #         #    #    #         #    #         #    #         #         #         #
#    #####################    #    ######    #    #    ###############################    ######    #
#                        #              #    #    #                             #         #         #
#    ################    ###########    #    ###############################    #    ######    ######
#    #              #                   #                             #         #              #    #
#    #    ######    ######    ######    ################    #    ######    #####################    #
#         #         #         #                             #
#####################################################################################################
