   --+#                                   #
     |  #                                 #
    #+--+#                                #
     #  |  #                              #
       #+--+#                             #
        #  |  #                           #######################
          #+--+#                                                #
           #  |  #                                              #
             #+--+#                                             #
              #  |  #                                           #
                #+--+#                                          #
                 #  |  #                                        #
                   #+--+#                                       #
                    #  |  #                                     #
                      #+--+#                                    #
                       #  |  #                                  #
                         #+--+#                                 #
                          #  |                                  #
                             |                                  #
                             |                                  #
                             |                                  #
                             |                                  #
                             |                       ############
                            #+------------------------          #
                             #                      #           #
                                                    #           #
                                                    #           #
                                                    #           #
#################################################################
