########+------+#########
--------+#    #|#########
########|##   #|#########
########|### ##|#########
########|###|##+-------+#
########|###|##|#######|#
########+---+##|#######|#
###############|#######|#
###############+-------+#
###############|#########
###############|#########
###############|#########
###############|#########
