#----#----#----#----#----#----#----#----#----#----#----#----#----#----#----#
               |              |                             |              |
#----#----#    #    #----#    #    #----#----#----#----#    #----#----#    #
|         |         |         |    |         |              |         |    |
#    #----#----#----#    #----#    #    #----#    #    #----#    #    #    #
|                   |              |    |         |    |         |         |
#----#----#----#    #----#----#----#    #    #----#    #    #----#----#    #
|              |                   |         |    |    |         |         |
#    #----#----#----#----#----#    #    #----#    #    #----#    #    #----#
|                   |         |         |              |    |    |         |
#----#----#----#    #    #    #----#----#----#    #----#    #    #----#    #
|                   |    |    |                   |         |         |    |
#    #----#----#    #    #    #    #----#----#----#    #    #----#    #    #
|              |         |    |         |         |    |    |         |    |
#----#----#----#    #----#    #    #    #    #    #    #    #    #----#    #
|              |    |              |    |    |         |         |         |
#    #----#    #    #    #----#----#    #    #----#----#----#----#    #----#
|         |    |    |    |         |    |         |              |    |    |
#----#    #    #    #    #----#    #----#----#    #    #----#    #    #    #
|    |    |    |    |                             |    |         |         |
#    #    #    #----#----#----#    #----#----#----#    #----#    #----#----#
|         |                                            |         |         |
#----#----#----#----#----#----#    #----#----#----#----#    #    #    #    #
|                             |         |              |    |    |    |    |
#    #----#----#----#----#    #----#    #    #----#    #    #    #    #    #
|              |         |              |         |         |         |    |
#----#----#    #    #----#----#----#----#----#    #----#----#----#----#    #
|    |         |         |              |         |         |              |
#    #    #    #----#    #    #----#----#    #----#    #    #----#----#    #
|         |              |                   |         |
#----#----#----#----#----#----#----#----#----#----#----#----#----#----#----#
