#----#----#----#----#----#----#----#----#----#----#----#----#
          |                        |                   |    |
#----#    #    #----#----#----#    #    #----#----#    #    #
|         |         |              |    |              |    |
#    #----#----#    #    #----#    #    #----#----#    #    #
|              |    |         |    |         |         |    |
#----#----#    #    #----#    #----#----#    #    #----#    #
|    |         |         |    |         |    |              |
#    #    #----#----#    #    #    #    #    #----#----#----#
|    |    |    |         |         |         |              |
#    #    #    #    #----#    #----#    #----#----#----#    #
|    |              |         |         |         |         |
#    #----#    #----#----#----#    #----#    #    #    #    #
|              |    |         |         |    |    |    |    |
#----#----#----#    #    #    #    #    #    #    #    #    #
|         |              |         |         |    |    |    |
#    #    #    #----#----#----#----#----#----#    #    #    #
|    |         |                        |         |    |    |
#    #----#----#----#----#----#----#    #    #----#----#    #
|                        |              |         |         |
#----#----#----#----#    #    #----#----#----#    #    #----#
|         |              |    |    |              |         |
#    #    #----#----#    #    #    #    #----#----#----#    #
|    |                   |    |         |                   |
#    #----#----#----#----#    #----#----#    #----#----#----#
|                                            |              |
#----#----#----#    #----#----#----#----#    #----#----#    #
|    |              |         |         |         |         |
#    #    #----#    #    #    #    #    #----#    #    #----#
|         |    |         |         |         |    |    |    |
#----#----#    #----#----#----#----#----#    #    #    #    #
|         |                             |    |    |    |    |
#    #    #----#----#    #    #----#    #    #    #    #    #
|    |                   |    |    |         |              |
#    #----#----#----#----#    #    #----#----#----#    #----#
|    |              |    |         |              |    |    |
#    #    #----#    #    #----#----#    #----#    #    #    #
|         |         |              |    |         |         |
#    #----#    #----#    #----#    #    #    #----#----#    #
|         |    |         |    |         |    |         |    |
#----#    #    #    #----#    #----#----#    #    #    #    #
|         |    |    |              |         |    |    |    |
#    #----#    #    #    #----#----#    #----#----#    #    #
|    |              |              |              |    |    |
#    #----#----#----#----#----#    #----#----#    #    #----#
|              |    |         |                   |         |
#----#----#    #    #    #    #----#----#----#----#----#    #
|         |         |    |    |                   |    |    |
#    #----#----#    #    #    #    #----#----#    #    #    #
|                        |    |              |         |    |
#----#----#----#----#----#    #----#----#----#    #    #    #
|                             |                   |    |    |
#    #----#----#----#----#----#    #----#----#----#    #    #
|    |         |         |              |              |    |
#    #    #    #    #    #----#----#    #    #----#----#    #
|         |    |    |              |    |              |    |
#----#----#    #    #----#----#    #    #----#----#    #    #
|              |              |    |         |    |    |    |
#    #----#----#----#----#    #    #----#    #    #    #    #
|    |                        |              |         |    |
#    #    #----#----#----#----#----#    #----#    #----#    #
|         |    |                   |    |    |    |         |
#----#----#    #    #----#    #    #    #    #    #    #----#
|              |         |    |         |    |              |
#    #    #----#----#    #----#----#----#    #----#----#----#
|    |              |    |         |                        |
#    #----#----#    #    #    #    #----#    #----#----#    #
|    |         |         |    |         |         |         |
#    #    #    #----#----#    #----#    #----#    #    #----#
|         |                   |                   |
#----#----#----#----#----#----#----#----#----#----#----#----#
