---------------
|......|......|
|.#.##.#.##.#.|
|.............|
|.#.#.###.#.#.|
|...|..#..|...|
--#.##.#.##.#--
__|.#.....#.|__
   ...===...   
__|.#.....#.|__
--#.##.#.##.#--
|...|..#..|...|
|.#.#.###.#.#.|
|.............|
|.#.##.#.##.#.|
|......|......|
---------------
